what jobs are there for titleid0 who know languageid0 ?	job ( ANS ) , title ( ANS , titleid0 ) , language ( ANS , languageid0 )
what titleid0 jobs are there in locid0 ?	title ( ANS , titleid0 ) , job ( ANS ) , loc ( ANS , locid0 )
what jobs pay num_salary are located in locid0 and require a degree ?	job ( ANS ) , salary_greater_than ( ANS , num_salary , year ) , loc ( ANS , locid0 ) , req_deg ( ANS )
what jobs are there for languageid0 titleid0s who dont know languageid1 ?	job ( ANS ) , language ( ANS , languageid0 ) , \+ language ( ANS , languageid1 )
what jobs use languageid0 on companyid0 machines and pay num_salary ?	job ( ANS ) , language ( ANS , languageid0 ) , platform ( ANS , platformid0 ) , salary_greater_than ( ANS , num_salary , year )
what jobs use languageid0 on platformid0 and pay num_salary ?	job ( ANS ) , language ( ANS , languageid0 ) , platform ( ANS , platformid0 ) , salary_greater_than ( ANS , num_salary , year )
what jobs desire a degree but dont use languageid0 ?	job ( ANS ) , des_deg ( ANS ) , \+ language ( ANS , languageid0 )
show me the jobs using languageid0 that require a degid0 but desire a degid1 ?	job ( ANS ) , language ( ANS , languageid0 ) , req_deg ( ANS , degid0 ) , des_deg ( ANS , degid1 )
what jobs on platformid0 are for programming languageid0 and desire year0 years experience ?	job ( ANS ) , platform ( ANS , platformid0 ) , language ( ANS , languageid0 ) , des_exp ( ANS , year0 )
show me jobs for companyid0 requiring experience on platformid0 ?	job ( ANS ) , company ( ANS , companyid0 ) , req_exp ( ANS ) , platform ( ANS , platformid0 )
show me jobs at companyid0 requiring no experience and a degid0 ?	job ( ANS ) , company ( ANS , companyid0 ) , \+ req_exp ( ANS ) , req_deg ( ANS , degid0 )
show me titleid0 jobs at companyid0 ?	title ( ANS , titleid0 ) , job ( ANS ) , company ( ANS , companyid0 )
show me locid0 jobs with a salary of num_salary ?	loc ( ANS , locid0 ) , job ( ANS ) , salary_greater_than ( ANS , num_salary , year )
find all areaid0 administration jobs in locid0 ?	area ( ANS , areaid0 ) , job ( ANS ) , loc ( ANS , locid0 )
find all languageid0 jobs in locid0 ?	language ( ANS , languageid0 ) , job ( ANS ) , loc ( ANS , locid0 )
show me a companyid0 job in locid0 requiring a degid0 ?	company ( ANS , companyid0 ) , job ( ANS ) , loc ( ANS , locid0 ) , req_deg ( ANS , degid0 )
which jobs in locid0 offer over num_salary in areaid0 ?	job ( ANS ) , loc ( ANS , locid0 ) , salary_greater_than ( ANS , num_salary , year ) , area ( ANS , areaid0 )
which jobs at companyid0 deal with languageid0 ?	job ( ANS ) , company ( ANS , companyid0 ) , language ( ANS , languageid0 )
which jobs are for degid0 majors with at least year0 years experience in platformid0 ?	job ( ANS ) , req_deg ( ANS , degid0 ) , req_exp ( ANS , year0 ) , platform ( ANS , platformid0 )
what are the positions within companyid0 that pay num_salary per year ?	job ( ANS ) , company ( ANS , companyid0 ) , salary_greater_than ( ANS , num_salary , year )
what jobs in locid0 have openings for a languageid0 titleid0 ?	job ( ANS ) , loc ( ANS , locid0 ) , language ( ANS , languageid0 ) , title ( ANS , titleid0 )
show me the job application for titleid0 ?	job ( ANS ) , title ( ANS , titleid0 )
are there any jobs specializing in areaid0 with companyid0 ?	job ( ANS ) , area ( ANS , areaid0 ) , company ( ANS , companyid0 )
what jobs are recruiterid0 employment hiring for ?	job ( ANS ) , recruiter ( ANS , recruiterid0 )
show me the jobs concerning areaid0 titleid0 on a platformid0 ?	job ( ANS ) , area ( ANS , areaid0 ) , title ( ANS , titleid0 ) , platform ( ANS , platformid0 )
what jobs in locid0 have a salary of num_salary ?	job ( ANS ) , loc ( ANS , locid0 ) , salary_greater_than ( ANS , num_salary , year )
show me jobs requiring a degid0 on platformid0s ?	job ( ANS ) , req_deg ( ANS , degid0 ) , platform ( ANS , platformid0 )
what jobs are there doing computer areaid0 on platformid0 machines ?	job ( ANS ) , area ( ANS , areaid0 ) , platform ( ANS , platformid0 )
which jobs pay num_salary that do not require a degid0 ?	job ( ANS ) , salary_greater_than ( ANS , num_salary , year ) , \+ req_deg ( ANS , degid0 )
what job is there for languageid1 but not languageid0 ?	job ( ANS ) , language ( ANS , languageid1 ) , \+ language ( ANS , languageid0 )
what jobs in locid0 require a degid0 ?	job ( ANS ) , loc ( ANS , locid0 ) , req_deg ( ANS , degid0 )
what jobs are available using applicationid0 with a specialty area of areaid0 ?	job ( ANS ) , application ( ANS , applicationid0 ) , area ( ANS , areaid0 )
show me the jobs using languageid0 with companyid0 in locid0 ?	job ( ANS ) , language ( ANS , languageid0 ) , company ( ANS , companyid0 ) , loc ( ANS , locid0 )
what jobs pay num_salary per year that require a degid0 ?	job ( ANS ) , salary_greater_than ( ANS , num_salary , year ) , req_deg ( ANS , degid0 )
show me the jobs in locid0 using areaid0 on platformid0 ?	job ( ANS ) , loc ( ANS , locid0 ) , area ( ANS , areaid0 ) , platform ( ANS , platformid0 )
are there any jobs at companyid0 that require no experience and pay num_salary ?	job ( ANS ) , company ( ANS , companyid0 ) , \+ req_exp ( ANS ) , salary_greater_than ( ANS , num_salary , year )
list all jobs using languageid0 and languageid1 in locid0 ?	job ( ANS ) , language ( ANS , languageid0 ) , language ( ANS , languageid1 ) , loc ( ANS , locid0 )
show all titleid0 positions in locid0 with areaid0 and languageid0 ?	title ( ANS , titleid0 ) , job ( ANS ) , loc ( ANS , locid0 ) , area ( ANS , areaid0 ) , language ( ANS , languageid0 )
show me jobs in locid0 using platformid0 that do not require a degid0 ?	job ( ANS ) , loc ( ANS , locid0 ) , platform ( ANS , platformid0 ) , \+ req_deg ( ANS , degid0 )
what jobs in locid0 only require a degid0 and no experience ?	job ( ANS ) , loc ( ANS , locid0 ) , req_deg ( ANS , degid0 ) , \+ req_exp ( ANS )
what jobs have a recruiter named recruiterid0 ?	job ( ANS ) , recruiter ( ANS , recruiterid0 )
what titleid0 jobs are available from companyid0 ?	title ( ANS , titleid0 ) , job ( ANS ) , company ( ANS , companyid0 )
what jobs using languageid0 and languageid1 are available in locid0 and pay num_salary a year ?	job ( ANS ) , language ( ANS , languageid0 ) , language ( ANS , languageid1 ) , loc ( ANS , locid0 ) , salary_greater_than ( ANS , num_salary , year )
are there any jobs in the us with the title titleid0 ?	job ( ANS ) , title ( ANS , titleid0 )
list the positions that require a knowledge of companyid0 applicationid0 ?	job ( ANS ) , application ( ANS , applicationid0 )
show me positions in areaid0 programming ?	job ( ANS ) , area ( ANS , areaid0 )
give some jobs in locid0 on a platformid0 system ?	job ( ANS ) , loc ( ANS , locid0 ) , platform ( ANS , platformid0 )
show me jobs using languageid0 that require a degid0 and desire a degid0 ?	job ( ANS ) , language ( ANS , languageid0 ) , req_deg ( ANS , degid0 ) , des_deg ( ANS , degid1 )
what jobs in locid0 require year0 years of experience but desire year1 years of experience ?	job ( ANS ) , loc ( ANS , locid0 ) , req_exp ( ANS , year0 ) , des_exp ( ANS , year1 )
what jobs at companyid0 require a degid0 ?	job ( ANS ) , company ( ANS , companyid0 ) , req_deg ( ANS , degid0 )
what jobs in locid0 require no experience ?	job ( ANS ) , loc ( ANS , locid0 ) , \+ req_exp ( ANS )
what jobs are there with a salary of num_salary ?	job ( ANS ) , salary_greater_than ( ANS , num_salary , year )
what languageid0 jobs are in locid0 ?	language ( ANS , languageid0 ) , job ( ANS ) , loc ( ANS , locid0 )
what are the languageid0 jobs in locid0 requiring a degid0 ?	language ( ANS , languageid0 ) , job ( ANS ) , loc ( ANS , locid0 ) , req_deg ( ANS , degid0 )
what jobs are there in locid0 that use languageid0 and require no experience ?	job ( ANS ) , loc ( ANS , locid0 ) , language ( ANS , languageid0 ) , \+ req_exp ( ANS )
show me the jobs in locid0 that desire year0 years of experience and use languageid0 ?	job ( ANS ) , loc ( ANS , locid0 ) , des_exp ( ANS , year0 ) , language ( ANS , languageid0 )
show me jobs requiring no experience ?	job ( ANS ) , \+ req_exp ( ANS )
show me jobs in locid0 ?	job ( ANS ) , loc ( ANS , locid0 )
show me jobs not involving languageid0 ?	job ( ANS ) , \+ language ( ANS , languageid0 )
show me areaid0 jobs which recruiterid0 is recruiting for ?	area ( ANS , areaid0 ) , job ( ANS ) , recruiter ( ANS , recruiterid0 )
what areaid0 positions require only a degid0 ?	area ( ANS , areaid0 ) , job ( ANS ) , req_deg ( ANS , degid0 )
show me the jobs with num_salary salary ?	job ( ANS ) , salary_greater_than ( ANS , num_salary , year )
show me the titleid0 job in locid0 ?	title ( ANS , titleid0 ) , job ( ANS ) , loc ( ANS , locid0 )
any jobs available using areaid0 ?	job ( ANS ) , area ( ANS , areaid0 )
are there any jobs with a salary of num_salary ?	job ( ANS ) , salary_greater_than ( ANS , num_salary , year )
are there any titleid0 positions open ?	title ( ANS , titleid0 ) , job ( ANS )
are there any applicationid0 jobs open ?	application ( ANS , applicationid0 ) , job ( ANS )
what companyid0 jobs do not require a degid0 ?	company ( ANS , companyid0 ) , job ( ANS ) , \+ req_deg ( ANS , degid0 )
what companyid0 jobs require using languageid0 on platformid0 ?	company ( ANS , companyid0 ) , job ( ANS ) , language ( ANS , languageid0 ) , platform ( ANS , platformid0 )
what jobs require year0 years of experience require a degid0 in cs are in languageid0 and are located in locid0 ?	job ( ANS ) , req_exp ( ANS , year0 ) , req_deg ( ANS , degid0 ) , language ( ANS , languageid0 ) , loc ( ANS , locid0 )
what jobs does recruiterid0 recruit for ?	job ( ANS ) , recruiter ( ANS , recruiterid0 )
show me locid0 jobs using languageid0 in the specialty area of areaid0 ?	loc ( ANS , locid0 ) , job ( ANS ) , language ( ANS , languageid0 ) , area ( ANS , areaid0 )
show me jobs in locid0 using languageid0 on platformid0 requiring a degid0 ?	job ( ANS ) , loc ( ANS , locid0 ) , language ( ANS , languageid0 ) , platform ( ANS , platformid0 ) , req_deg ( ANS , degid0 )
show me jobs with the platformid0 in the specialty area of areaid0 ?	job ( ANS ) , platform ( ANS , platformid0 ) , area ( ANS , areaid0 )
show me areaid0 jobs in locid0 requiring an degid0 and the knowledge of languageid0 ?	area ( ANS , areaid0 ) , job ( ANS ) , loc ( ANS , locid0 ) , req_deg ( ANS , degid0 ) , language ( ANS , languageid0 )
show me jobs in computer areaid0 requiring a degid0 in art and knowledge of applicationid0 ?	job ( ANS ) , area ( ANS , areaid0 ) , req_deg ( ANS , degid0 ) , application ( ANS , applicationid0 )
show me the jobs at companies in locid0 that want a degree in degid0 ?	job ( ANS ) , loc ( ANS , locid0 ) , des_deg ( ANS , degid0 )
show the jobs offering num_salary working with languageid0 on platformid0 ?	job ( ANS ) , salary_greater_than ( ANS , num_salary , year ) , language ( ANS , languageid0 ) , platform ( ANS , platformid0 )
show the jobs with the title titleid0 requiring year0 years of experience ?	job ( ANS ) , title ( ANS , titleid0 ) , req_exp ( ANS , year0 )
show the jobs using languageid0 not requiring a degid0 ?	job ( ANS ) , language ( ANS , languageid0 ) , \+ req_deg ( ANS , degid0 )
what positions are there in areaid0 ?	job ( ANS ) , area ( ANS , areaid0 )
show me all job that are available ?	job ( ANS )
show the jobs for degid0 in locid0 ?	req_deg ( ANS , degid0 ) , loc ( ANS , locid0 )
what are the jobs that require experience with applicationid0 ?	job ( ANS ) , req_exp ( ANS ) , application ( ANS , applicationid0 )
are there any jobs using languageid0 with companyid0 ?	job ( ANS ) , language ( ANS , languageid0 ) , company ( ANS , companyid0 )
show me the jobs that require year0 years experience ?	job ( ANS ) , req_exp ( ANS , year0 )
are there any titleid0 jobs open ?	job ( ANS ) , title ( ANS , titleid0 )
what jobs as an titleid0 pay num_salary ?	job ( ANS ) , title ( ANS , titleid0 ) , salary_greater_than ( ANS , num_salary , year )
are there any jobs using languageid0 that dont require a degid0 ?	job ( ANS ) , language ( ANS , languageid0 ) , \+ req_deg ( ANS , degid0 )
show me the languageid0 jobs in locid0 that desire year0 years experience ?	language ( ANS , languageid0 ) , job ( ANS ) , loc ( ANS , locid0 ) , des_exp ( ANS , year0 )
show me the jobs using languageid0 requiring a degid0 ?	job ( ANS ) , language ( ANS , languageid0 ) , req_deg ( ANS , degid0 )
are there any jobs in languageid0 that the salary is num_salary ?	job ( ANS ) , language ( ANS , languageid0 ) , salary_greater_than ( ANS , num_salary , year )
show me the jobs that are not in languageid0 ?	job ( ANS ) , \+ language ( ANS , languageid0 )
show me the jobs requiring year0 years of experience at companyid0 ?	job ( ANS ) , req_exp ( ANS , year0 ) , company ( ANS , companyid0 )
what jobs using languageid0 are there in locid0 ?	job ( ANS ) , language ( ANS , languageid0 ) , loc ( ANS , locid0 )
show me the areaid0 jobs in locid0 with a salary of num_salary ?	area ( ANS , areaid0 ) , job ( ANS ) , loc ( ANS , locid0 ) , salary_greater_than ( ANS , num_salary , year )
show me the titleid0 jobs which require a degid0 ?	job ( ANS ) , title ( ANS , titleid0 ) , req_deg ( ANS , degid0 )
what jobs desire year0 years of experience with languageid0 on platformid0 ?	job ( ANS ) , des_exp ( ANS , year0 ) , language ( ANS , languageid0 ) , platform ( ANS , platformid0 )
show me locid0 jobs using languageid0 on platformid0 ?	loc ( ANS , locid0 ) , job ( ANS ) , language ( ANS , languageid0 ) , platform ( ANS , platformid0 )
what applicationid0 jobs are there with companyid0 in locid0 using platformid0 ?	application ( ANS , languageid0 ) , job ( ANS ) , company ( ANS , companyid0 ) , loc ( ANS , locid0 ) , platform ( ANS , platformid0 )
are there any jobs in locid0 requiring at least a degid0 and knowing languageid0 ?	job ( ANS ) , loc ( ANS , locid0 ) , req_deg ( ANS , degid0 ) , language ( ANS , languageid0 )
what are the jobs in locid0 that require at least year0 years of experience ?	job ( ANS ) , loc ( ANS , locid0 ) , req_exp ( ANS , year0 )
are there any jobs using languageid0 that are not with companyid0 ?	job ( ANS ) , language ( ANS , languageid0 ) , \+ company ( ANS , companyid0 )
show me the jobs that operate on platformid0 ?	job ( ANS ) , platform ( ANS , platformid0 )
are there any platformid0 titleid0 jobs ?	platform ( ANS , platformid0 ) , title ( ANS , titleid0 ) , job ( ANS )
what are the jobs that pay num_salary per year ?	job ( ANS ) , salary_greater_than ( ANS , num_salary , year )
show jobs in locid0 that require a degid0 ?	job ( ANS ) , loc ( ANS , locid0 ) , req_deg ( ANS , degid0 )
give me jobs requiring degid0 ?	job ( ANS ) , req_deg ( ANS , degid
show the jobs on platformid0 ?	job ( ANS ) , platform ( ANS , platformid0 )
what jobs are there on platformid0 ?	job ( ANS ) , platform ( ANS , platformid0 )
list jobs requiring degid0 ?	job ( ANS ) , req_deg ( ANS , degid0 )
tell me jobs in areaid0 ?	job ( ANS ) , area ( ANS , areaid0 )
are there any jobs on platformid0 ?	job ( ANS ) , platform ( ANS , platformid0 )
are there any jobs requiring degid0 ?	job ( ANS ) , req_deg ( ANS , degid0 )
are there any jobs for a areaid0 specialist ?	job ( ANS ) , area ( ANS , areaid0 )
what jobs are there in locid0 ?	job ( ANS ) , country ( ANS , locid0 )
list the jobs in languageid0 ?	job ( ANS ) , language ( ANS , languageid0 )
show jobs using languageid0 ?	job ( ANS ) , language ( ANS , languageid0 )
tell me the jobs using languageid0 ?	job ( ANS ) , language ( ANS , languageid0 )
show jobs using languageid0 ?	job ( ANS ) , language ( ANS , languageid0 )
list the jobs for a areaid0 specialist ?	job ( ANS ) , area ( ANS , areaid0 )
show the jobs requiring degid0 ?	job ( ANS ) , req_deg ( ANS , degid0 )
are there any jobs requiring degid0 ?	job ( ANS ) , req_deg ( ANS , degid0 )
what jobs are there requiring degid0 ?	job ( ANS ) , req_deg ( ANS , degid0 )
list the jobs for a areaid0 specialist ?	job ( ANS ) , area ( ANS , areaid0 )
are there any jobs on platformid0 ?	job ( ANS ) , platform ( ANS , platformid0 )
show jobs using languageid0 ?	job ( ANS ) , language ( ANS , languageid0 )
show the jobs on platformid0 ?	job ( ANS ) , platform ( ANS , platformid0 )
are there any jobs on platformid0 ?	job ( ANS ) , platform ( ANS , platformid0 )
show the jobs for a areaid0 specialist ?	job ( ANS ) , area ( ANS , areaid0 )
show jobs in languageid0 ?	job ( ANS ) , language ( ANS , languageid0 )
give me jobs in languageid0 ?	job ( ANS ) , language ( ANS , languageid0 )
tell me jobs using languageid0 ?	job ( ANS ) , language ( ANS , languageid0 )
what jobs are there for a areaid0 specialist ?	job ( ANS ) , area ( ANS , areaid0 )
tell me the jobs on platformid0 ?	job ( ANS ) , platform ( ANS , platformid0 )
what jobs are there in areaid0 ?	job ( ANS ) , area ( ANS , areaid0 )
list the jobs using languageid0 ?	job ( ANS ) , language ( ANS , languageid0 )
give me the jobs in languageid0 ?	job ( ANS ) , language ( ANS , languageid0 )
what jobs are there for a areaid0 specialist ?	job ( ANS ) , area ( ANS , areaid0 )
show the jobs in languageid0 ?	job ( ANS ) , language ( ANS , languageid0 )
what jobs are there in locid0 ?	job ( ANS ) , country ( ANS , locid0 )
show the jobs requiring degid0 in locid0 ?	job ( ANS ) , req_deg ( ANS , degid0 ) , country ( ANS , locid0 )
give me jobs using languageid0 ?	job ( ANS ) , language ( ANS , languageid0 )
what jobs are there in areaid0 ?	job ( ANS ) , area ( ANS , areaid0 )
list the jobs in areaid0 ?	job ( ANS ) , area ( ANS , areaid0 )
what jobs are there on platformid0 ?	job ( ANS ) , platform ( ANS , platformid0 )
show the jobs using languageid0 ?	job ( ANS ) , language ( ANS , languageid0 )
tell me the jobs requiring degid0 ?	job ( ANS ) , req_deg ( ANS , degid0 )
are there any jobs in locid0 ?	job ( ANS ) , loc ( ANS , locid0 )
are there any jobs using languageid0 ?	job ( ANS ) , language ( ANS , languageid0 )
tell me the jobs on platformid0 ?	job ( ANS ) , platform ( ANS , platformid0 )
list jobs in areaid0 ?	job ( ANS ) , area ( ANS , areaid0 )
what jobs are there using languageid0 ?	job ( ANS ) , language ( ANS , languageid0 )
show the jobs in locid0 ?	job ( ANS ) , loc ( ANS , locid0 )
show the jobs requiring degid0 ?	job ( ANS ) , req_deg ( ANS , degid0 )
are there any jobs in locid0 ?	job ( ANS ) , loc ( ANS , locid0 )
what jobs are there requiring degid0 ?	job ( ANS ) , req_deg ( ANS , degid0 )
give me the jobs for a areaid0 specialist ?	job ( ANS ) , area ( ANS , areaid0 )
list the jobs requiring degid0 ?	job ( ANS ) , req_deg ( ANS , degid0 )
are there any jobs for a areaid0 specialist ?	job ( ANS ) , area ( ANS , areaid0 )
are there any jobs using languageid0 ?	job ( ANS ) , language ( ANS , languageid0 )
are there any jobs requiring degid0 ?	job ( ANS ) , req_deg ( ANS , degid0 )
list jobs on platformid0 ?	job ( ANS ) , platform ( ANS , platformid0 )
tell me the jobs requiring degid0 in locid0 ?	job ( ANS ) , req_deg ( ANS , degid0 ) , loc ( ANS , locid0 )
list jobs in locid0 ?	job ( ANS ) , loc ( ANS , locid0 )
show the jobs for a areaid0 specialist ?	job ( ANS ) , area ( ANS , areaid0 )
show the jobs in locid0 ?	job ( ANS ) , loc ( ANS , locid0 )
are there any jobs requiring degid0 ?	job ( ANS ) , req_deg ( ANS , degid0 )
list jobs requiring degid0 ?	job ( ANS ) , req_deg ( ANS , degid0 )
are there any jobs requiring degid0 ?	job ( ANS ) , req_deg ( ANS , degid0 )
give me the jobs requiring degid0 ?	job ( ANS ) , req_deg ( ANS , degid0 )
show jobs on platformid0 ?	job ( ANS ) , platform ( ANS , platformid0 )
what jobs are there for a areaid0 specialist ?	job ( ANS ) , area ( ANS , areaid0 )
what jobs are there requiring degid0 ?	job ( ANS ) , req_deg ( ANS , degid0 )
what jobs are there on platformid0 ?	job ( ANS ) , platform ( ANS , platformid0 )
list the jobs using languageid0 ?	job ( ANS ) , language ( ANS , languageid0 )
list the jobs on platformid0 ?	job ( ANS ) , platform ( ANS , platformid0 )
what jobs are there requiring degid0 ?	job ( ANS ) , req_deg ( ANS , degid0 )
are there any jobs on platformid0 ?	job ( ANS ) , platform ( ANS , platformid0 )
what jobs are there for a areaid0 specialist ?	job ( ANS ) , area ( ANS , areaid0 )
give me jobs for a areaid0 specialist ?	job ( ANS ) , area ( ANS , areaid0 )
list jobs using languageid0 ?	job ( ANS ) , language ( ANS , languageid0 )
give me the jobs for a areaid0 specialist ?	job ( ANS ) , area ( ANS , areaid0 )
list jobs in areaid0 ?	job ( ANS ) , area ( ANS , areaid0 )
are there any jobs in areaid0 ?	job ( ANS ) , area ( ANS , areaid0 )
show jobs in locid0 ?	job ( ANS ) , loc ( ANS , locid0 )
are there any jobs for a areaid0 specialist ?	job ( ANS ) , area ( ANS , areaid0 )
what jobs are there using languageid0 ?	job ( ANS ) , language ( ANS , languageid0 )
what jobs are there on platformid0 ?	job ( ANS ) , platform ( ANS , platformid0 )
what jobs are there for a areaid0 specialist ?	job ( ANS ) , area ( ANS , areaid0 )
tell me jobs using languageid0 ?	job ( ANS ) , language ( ANS , languageid0 )
what jobs are there in locid0 on platformid0 ?	job ( ANS ) , loc ( ANS , locid0 ) , platform ( ANS , platformid0 )
show jobs requiring degid0 ?	job ( ANS ) , req_deg ( ANS , degid0 )
give me jobs in locid0 ?	job ( ANS ) , loc ( ANS , locid0 )
give me jobs requiring degid0 ?	job ( ANS ) , req_deg ( ANS , degid0 )
what jobs are there on platformid0 ?	job ( ANS ) , platform ( ANS , platformid0 )
list the jobs using languageid0 for a areaid0 specialist ?	job ( ANS ) , language ( ANS , languageid0 ) , area ( ANS , areaid0 )
are there any jobs requiring degid0 ?	job ( ANS ) , req_deg ( ANS , degid0 )
what jobs are there on platformid0 ?	job ( ANS ) , platform ( ANS , platformid0 )
give me the jobs on platformid0 ?	job ( ANS ) , platform ( ANS , platformid0 )
what jobs are there using languageid0 ?	job ( ANS ) , language ( ANS , languageid0 )
are there any jobs using languageid0 in locid0 ?	job ( ANS ) , language ( ANS , languageid0 ) , loc ( ANS , locid0 )
give me the jobs for a areaid0 specialist in locid0 ?	job ( ANS ) , area ( ANS , areaid0 ) , loc ( ANS , locid0 )
give me the jobs for a areaid0 specialist ?	job ( ANS ) , area ( ANS , areaid0 )
are there any jobs using languageid0 ?	job ( ANS ) , language ( ANS , languageid0 )
give me jobs in locid0 ?	job ( ANS ) , loc ( ANS , locid0 )
tell me the jobs using languageid0 ?	job ( ANS ) , language ( ANS , languageid0 )
list jobs in locid0 ?	job ( ANS ) , loc ( ANS , locid0 )
what jobs are there using languageid0 ?	job ( ANS ) , language ( ANS , languageid0 )
list the jobs in languageid0 ?	job ( ANS ) , language ( ANS , languageid0 )
are there any jobs in locid0 ?	job ( ANS ) , loc ( ANS , locid0 )
are there any titleid0 jobs requiring degid0 ?	title ( ANS , titleid0 ) , job ( ANS ) , req_deg ( ANS , degid0 )
tell me the jobs in areaid0 ?	job ( ANS ) , area ( ANS , areaid0 )
give me jobs on platformid0 using languageid0 ?	job ( ANS ) , platform ( ANS , platformid0 ) , language ( ANS , languageid0 )
are there any jobs requiring degid0 ?	job ( ANS ) , req_deg ( ANS , degid0 )
list the jobs using languageid0 ?	job ( ANS ) , language ( ANS , languageid0 )
give me the jobs in locid0 ?	job ( ANS ) , loc ( ANS , locid0 )
list jobs using languageid0 ?	job ( ANS ) , language ( ANS , languageid0 )
show the jobs on platformid0 requiring degid0 ?	job ( ANS ) , platform ( ANS , platformid0 ) , req_deg ( ANS , degid0 )
are there any jobs requiring degid0 ?	job ( ANS ) , req_deg ( ANS , degid0 )
show the jobs in areaid0 ?	job ( ANS ) , area ( ANS , areaid0 )
tell me jobs for a areaid0 specialist ?	job ( ANS ) , area ( ANS , areaid0 )
what jobs are there for a areaid0 specialist ?	job ( ANS ) , area ( ANS , areaid0 )
give me the jobs using languageid0 ?	job ( ANS ) , language ( ANS , languageid0 )
list jobs requiring degid0 using languageid0 ?	job ( ANS ) , req_deg ( ANS , degid0 ) , language ( ANS , languageid0 )
show jobs for a areaid0 specialist ?	job ( ANS ) , area ( ANS , areaid0 )
tell me jobs using languageid0 ?	job ( ANS ) , language ( ANS , languageid0 )
what jobs are there using languageid0 ?	job ( ANS ) , language ( ANS , languageid0 )
show the jobs on platformid0 ?	job ( ANS ) , platform ( ANS , platformid0 )
show jobs requiring degid0 ?	job ( ANS ) , req_deg ( ANS , degid0 )
tell me the jobs requiring degid0 using languageid0 ?	job ( ANS ) , req_deg ( ANS , degid0 ) , language ( ANS , languageid0 )
give me jobs in locid0 using languageid0 ?	job ( ANS ) , loc ( ANS , locid0 ) , language ( ANS , languageid0 )
list jobs in languageid0 ?	job ( ANS ) , language ( ANS , languageid0 )
show the jobs in locid0 ?	job ( ANS ) , loc ( ANS , locid0 )
are there any jobs on platformid0 ?	job ( ANS ) , platform ( ANS , platformid0 )
what jobs require a degid0 ?	job ( ANS ) , req_deg ( ANS , degid0 )
are there any jobs for a titleid0 ?	job ( ANS ) , title ( ANS , titleid0 )
what jobs need at least year0 years of experience ?	job ( ANS ) , req_exp ( ANS , year0 )
what jobs are there for a titleid0 using languageid0 ?	job ( ANS ) , title ( ANS , titleid0 ) , language ( ANS , languageid0 )
are there any jobs that require a knowledge of platformid0 in locid0 ?	job ( ANS ) , platform ( ANS , platformid0 ) , loc ( ANS , locid0 )
give me jobs on the platformid0 using languageid0 ?	job ( ANS ) , platform ( ANS , platformid0 ) , language ( ANS , languageid0 )
what jobs are there for a languageid0 titleid0 ?	job ( ANS ) , language ( ANS , languageid0 ) , title ( ANS , titleid0 )
what are all the jobs ?	job ( ANS )
could you list all the jobs ?	job ( ANS )
give me a list of all the jobs ?	job ( ANS )
show me jobs in locid0 that use languageid0 on platformid0 for a titleid0 paying at least num_salary ?	job ( ANS ) , loc ( ANS , locid0 ) , language ( ANS , languageid0 ) , platform ( ANS , platformid0 ) , title ( ANS , titleid0 ) , salary_greater_than ( ANS , num_salary , year )
what jobs use languageid0 with the areaid0 on platformid0s ?	job ( ANS ) , language ( ANS , languageid0 ) , area ( ANS , areaid0 ) , platform ( ANS , platformid0 )
what jobs in locid0 pay num_salary for languageid0 titleid0 ?	job ( ANS ) , loc ( ANS , locid0 ) , salary_greater_than ( ANS , num_salary , year ) , language ( ANS , languageid0 ) , title ( ANS , titleid0 )
what jobs in locid0 are for a languageid0 titleid0 that involve platformid0 and the areaid0 ?	job ( ANS ) , loc ( ANS , locid0 ) , language ( ANS , languageid0 ) , title ( ANS , titleid0 ) , platform ( ANS , platformid0 ) , area ( ANS , areaid0 )
show me everything ?	job ( ANS )
what jobs are there ?	job ( ANS )
all of it ?	job ( ANS )
everything ?	job ( ANS )
what jobs in locid0 offer a languageid0 titleid0 for num_salary a year ?	job ( ANS ) , loc ( ANS , locid0 ) , language ( ANS , languageid0 ) , title ( ANS , titleid0 ) , salary_greater_than ( ANS , num_salary , year )
what jobs in locid0 require languageid0 and areaid0 experience ?	job ( ANS ) , loc ( ANS , locid0 ) , language ( ANS , languageid0 ) , area ( ANS , areaid0 ) , req_exp ( ANS )
are there jobs using languageid0 in locid0 with applicationid0 and on platformid0 ?	job ( ANS ) , language ( ANS , languageid0 ) , loc ( ANS , locid0 ) , application ( ANS , applicationid0 ) , platform ( ANS , platformid0 )
are there any jobs in locid0 developing areaid0 in platformid0 using languageid0 ?	job ( ANS ) , loc ( ANS , locid0 ) , area ( ANS , areaid0 ) , platform ( ANS , platformid0 ) , language ( ANS , languageid0 )
what jobs are there that dont require a degree but use languageid0 ?	job ( ANS ) , \+ req_deg ( ANS ) , language ( ANS , languageid0 )
what jobs are there for titleid0 who know languageid0 ?	job ( ANS ) , title ( ANS , titleid0 ) , language ( ANS , languageid0 )
what jobs desire a degree but dont use languageid0 ?	job ( ANS ) , des_deg ( ANS ) , \+ language ( ANS , languageid0 )
show me the jobs using languageid0 that require a degid0 but desire a degid1 ?	job ( ANS ) , language ( ANS , languageid0 ) , req_deg ( ANS , degid0 ) , des_deg ( ANS , degid1 )
what are the titleid0 jobs available using languageid0 ?	job ( ANS ) , language ( ANS , languageid0 ) , title ( ANS , titleid0 )
which titleid0 jobs in locid0 require year0 years experience and pay num_salary ?	title ( ANS , titleid0 ) , job ( ANS ) , loc ( ANS , locid0 ) , req_exp ( ANS , year0 ) , salary_greater_than ( ANS , num_salary , year )
what jobs on platformid0 are for programming languageid0 and desire year0 years experience ?	job ( ANS ) , platform ( ANS , platformid0 ) , language ( ANS , languageid0 ) , des_exp ( ANS , year0 )
show me jobs are companyid0 requiring experience on platformid0 ?	job ( ANS ) , company ( ANS , companyid0 ) , req_exp ( ANS ) , platform ( ANS , platformid0 )
show me locid0 jobs requiring a degid0 ?	loc ( ANS , locid0 ) , job ( ANS ) , req_deg ( ANS , degid0 )
show me jobs at companyid0 requiring no experience and a degid0 ?	job ( ANS ) , company ( ANS , companyid0 ) , \+ req_exp ( ANS ) , req_deg ( ANS , degid0 )
show me titleid0 jobs at companyid0 ?	title ( ANS , titleid0 ) , job ( ANS ) , company ( ANS , companyid0 )
show me titleid0 jobs requiring no experience on platformid0 ?	title ( ANS , titleid0 ) , job ( ANS ) , \+ ( req_exp ( ANS ) , platform ( ANS , platformid0 ) )
show me locid0 jobs with a salary of num_salary ?	loc ( ANS , locid0 ) , job ( ANS ) , salary_greater_than ( ANS , num_salary , year )
find all areaid0 administration jobs in locid0 ?	area ( ANS , areaid0 ) , job ( ANS ) , loc ( ANS , locid0 )
show me a companyid0 job in locid0 requiring a degid0 ?	company ( ANS , companyid0 ) , job ( ANS ) , loc ( ANS , locid0 ) , req_deg ( ANS , degid0 )
which jobs in locid0 offer over num_salary in areaid0 ?	job ( ANS ) , loc ( ANS , locid0 ) , salary_greater_than ( ANS , num_salary , year ) , area ( ANS , areaid0 )
which jobs at companyid0 deal with languageid0 ?	job ( ANS ) , company ( ANS , companyid0 ) , language ( ANS , languageid0 )
which jobs are for degid0 majors with at least year0 years experience in platformid0 ?	job ( ANS ) , req_deg ( ANS , degid0 ) , req_exp ( ANS , year0 ) , platform ( ANS , platformid0 )
what are the positions within companyid0 that pay num_salary per year ?	job ( ANS ) , company ( ANS , companyid0 ) , salary_greater_than ( ANS , num_salary , year )
what jobs in locid0 have openings for a languageid0 titleid0 ?	job ( ANS ) , loc ( ANS , locid0 ) , language ( ANS , languageid0 ) , title ( ANS , titleid0 )
are there any jobs specializing in areaid0 with companyid0 ?	job ( ANS ) , area ( ANS , areaid0 ) , company ( ANS , companyid0 )
what jobs are recruiterid0 employment hiring for ?	job ( ANS ) , recruiter ( ANS , recruiterid0 )
show me the jobs concerning areaid0 titleid0 on a platformid0 ?	job ( ANS ) , area ( ANS , areaid0 ) , title ( ANS , titleid0 ) , platform ( ANS , platformid0 )
what jobs in locid0 have a salary of num_salary ?	job ( ANS ) , loc ( ANS , locid0 ) , salary_greater_than ( ANS , num_salary , year )
show me jobs requiring a degid0 on platformid0 ?	job ( ANS ) , req_deg ( ANS , degid0 ) , platform ( ANS , platformid0 )
show me titleid0 jobs in locid0 ?	title ( ANS , titleid0 ) , job ( ANS ) , loc ( ANS , locid0 )
show me languageid0 jobs requiring a degid0 in locid0 ?	language ( ANS , languageid0 ) , job ( ANS ) , req_deg ( ANS , degid0 ) , loc ( ANS , locid0 )
show me jobs desiring a degid0 in locid0 with companyid0 ?	job ( ANS ) , des_deg ( ANS , degid0 ) , loc ( ANS , locid0 ) , company ( ANS , companyid0 )
how much experience is wanted for a job at companyid0 ?	req_exp ( A , ANS ) , job ( A ) , company ( A , companyid0 )
what programming languages are desired for a job as a titleid0 at companyid0 ?	language ( A , ANS ) , job ( A ) , title ( A , titleid0 ) , company ( A , companyid0 )
list the companies that desire languageid0 experience ?	company ( A , ANS ) , language ( A , languageid0 ) , des_exp ( A )
list the required experience for a job using languageid0 ?	req_exp ( A , ANS ) , job ( A ) , language ( A , languageid0 )
what are the jobs using languageid0 with salaries of num_salary ?	job ( ANS ) , language ( ANS , languageid0 ) , salary_greater_than ( ANS , num_salary , year )
what locations offer jobs using languageid0 on platformid0 ?	loc ( B , ANS ) , job ( B ) , language ( B , languageid0 ) , platform ( B , platformid0 )
what jobs are available using applicationid0 with a specialty area of areaid0 ?	job ( ANS ) , application ( ANS , applicationid0 ) , area ( ANS , areaid0 )
what positions are there that use languageid0 and languageid1 ?	job ( ANS ) , language ( ANS , languageid0 ) , language ( ANS , languageid1 )
show me the jobs using languageid0 with companyid0 in locid0 ?	job ( ANS ) , language ( ANS , languageid0 ) , company ( ANS , companyid0 ) , loc ( ANS , locid0 )
what jobs pay num_salary per year that desire a degid0 ?	job ( ANS ) , salary_greater_than ( ANS , num_salary , year ) , des_deg ( ANS , degid0 )
show me all of the titleid0 jobs in locid0 ?	title ( ANS , titleid0 ) , job ( ANS ) , loc ( ANS , locid0 )
show me the jobs in locid0 using areaid0 on platformid0 ?	job ( ANS ) , loc ( ANS , locid0 ) , area ( ANS , areaid0 ) , platform ( ANS , platformid0 )
show me jobs in locid0 using platformid0 that do not require a degid0 ?	job ( ANS ) , loc ( ANS , locid0 ) , platform ( ANS , platformid0 ) , \+ req_deg ( ANS , degid0 )
give me the jobs using languageid0 that dont require platformid0 ?	job ( ANS ) , language ( ANS , languageid0 ) , \+ platform ( ANS , platformid0 )
are there any jobs requiring a degid0 for companyid0 in locid0 ?	job ( ANS ) , req_deg ( ANS , degid0 ) , company ( ANS , companyid0 ) , loc ( ANS , locid0 )
show me the hardware platforms associated with a titleid0 with companyid0 ?	platform ( A , ANS ) , title ( A , titleid0 ) , company ( A , companyid0 )
what titleid0 positions in locid0 require no experience ?	title ( ANS , titleid0 ) , job ( ANS ) , loc ( ANS , locid0 ) , \+ req_exp ( ANS )
what titleid0 jobs are available from companyid0 ?	title ( ANS , titleid0 ) , job ( ANS ) , company ( ANS , companyid0 )
	
list the positions that require a knowledge of companyid0 applicationid0 ?	job ( ANS ) , application ( ANS , applicationid0 )
	
	
what jobs in locid0 require no experience ?	job ( ANS ) , loc ( ANS , locid0 ) , \+ req_exp ( ANS )
	
what languageid0 jobs are in locid0 ?	language ( ANS , languageid0 ) , job ( ANS ) , loc ( ANS , locid0 )
what are the languageid0 jobs in locid0 requiring a degid0 ?	language ( ANS , languageid0 ) , job ( ANS ) , loc ( ANS , locid0 ) , req_deg ( ANS , degid0 )
what jobs are there in locid0 that use languageid0 and require no experience ?	job ( ANS ) , loc ( ANS , locid0 ) , language ( ANS , languageid0 ) , \+ req_exp ( ANS )
show me the jobs in locid0 that desire year0 years of experience and use languageid0 ?	job ( ANS ) , loc ( ANS , locid0 ) , des_exp ( ANS , year0 ) , language ( ANS , languageid0 )
show me jobs requiring no experience ?	job ( ANS ) , \+ req_exp ( ANS )
	
show me jobs not involving languageid0 ?	job ( ANS ) , \+ language ( ANS , languageid0 )
show me areaid0 jobs which recruiterid0 is recruiting for ?	area ( ANS , areaid0 ) , job ( ANS ) , recruiter ( ANS , recruiterid0 )
	
show me the titleid0 job in locid0 ?	title ( ANS , titleid0 ) , job ( ANS ) , loc ( ANS , locid0 )
	
	
show me locid0 jobs desiring a degid0 ?	loc ( ANS , locid0 ) , job ( ANS ) , des_deg ( ANS , degid0 )
any jobs available using areaid0 ?	job ( ANS ) , area ( ANS , areaid0 )
are there any titleid0 positions open ?	title ( ANS , titleid0 ) , job ( ANS )
what languageid0 jobs are there with companyid0 in locid0 ?	language ( ANS , languageid0 ) , job ( ANS ) , company ( ANS , companyid0 ) , loc ( ANS , locid0 )
are there any applicationid0 jobs open ?	application ( ANS , applicationid0 ) , job ( ANS )
are there any jobs in locid0 ?	job ( ANS ) , loc ( ANS , locid0 )
	
what companyid0 jobs do not require a degid0 ?	company ( ANS , companyid0 ) , job ( ANS ) , \+ req_deg ( ANS , degid0 )
what companyid0 jobs require using languageid0 on platformid0 ?	company ( ANS , companyid0 ) , job ( ANS ) , language ( ANS , languageid0 ) , platform ( ANS , platformid0 )
what jobs require year0 years of experience require a degid0 are in languageid0 and are located in locid0 ?	job ( ANS ) , req_exp ( ANS , year0 ) , req_deg ( ANS , degid0 ) , language ( ANS , languageid0 ) , loc ( ANS , locid0 )
what jobs does companyid0 recruit for ?	job ( ANS ) , company ( ANS , companyid0 )
show me locid0 jobs using languageid0 in the specialty area of areaid0 ?	loc ( ANS , locid0 ) , job ( ANS ) , language ( ANS , languageid0 ) , area ( ANS , areaid0 )
show me jobs in locid0 using languageid0 on platformid0 requiring a degid0 ?	job ( ANS ) , loc ( ANS , locid0 ) , language ( ANS , languageid0 ) , platform ( ANS , platformid0 ) , req_deg ( ANS , degid0 )
show me areaid0 jobs in locid0 requiring an degid0 and the knowledge of languageid0 ?	area ( ANS , areaid0 ) , job ( ANS ) , loc ( ANS , locid0 ) , req_deg ( ANS , degid0 ) , language ( ANS , languageid0 )
	
show me the jobs at companies in locid0 that want a degree in degid0 ?	job ( ANS ) , loc ( ANS , locid0 ) , des_deg ( ANS , degid0 )
	
show the jobs with the title systems titleid0 requiring year0 years of experience ?	job ( ANS ) , title ( ANS , titleid0 ) , req_exp ( ANS , year0 )
show the jobs using languageid0 not requiring a degid0 ?	job ( ANS ) , language ( ANS , languageid0 ) , \+ req_deg ( ANS , degid0 )
show me all job that are available ?	job ( ANS )
show the companies that are looking for degid0 in locid0 ?	company ( X , ANS ) , req_deg ( X , degid0 ) , loc ( X , locid0 )
	
are there any jobs using languageid0 with companyid0 ?	job ( ANS ) , language ( ANS , languageid0 ) , company ( ANS , companyid0 )
	
show me the jobs that require year0 years experience ?	job ( ANS ) , req_exp ( ANS , year0 )
what jobs are in locid0 that are not at companyid0 ?	job ( ANS ) , loc ( ANS , locid0 ) , \+ company ( ANS , companyid0 )
	
show me the jobs using languageid0 requiring a degid0 ?	job ( ANS ) , language ( ANS , languageid0 ) , req_deg ( ANS , degid0 )
show me the jobs that are not in languageid0 ?	job ( ANS ) , \+ language ( ANS , languageid0 )
are there any jobs that require the knowledge of platformid0 platform ?	job ( ANS ) , platform ( ANS , platformid0 )
what jobs using languageid0 are there in locid0 ?	job ( ANS ) , language ( ANS , languageid0 ) , loc ( ANS , locid0 )
	
what jobs desire year0 years of experience with languageid0 on platformid0 ?	job ( ANS ) , des_exp ( ANS , year0 ) , language ( ANS , languageid0 ) , platform ( ANS , platformid0 )
are there any jobs using languageid0 that are not with companyid0 ?	job ( ANS ) , language ( ANS , languageid0 ) , \+ company ( ANS , companyid0 )
are there any platformid0 titleid0 jobs ?	platform ( ANS , platformid0 ) , title ( ANS , titleid0 ) , job ( ANS )
show jobs in locid0 that require a degid0 ?	job ( ANS ) , loc ( ANS , locid0 ) , req_deg ( ANS , degid0 )
what jobs are there for languageid0 platformid0 titleid0 ?	job ( ANS ) , language ( ANS , languageid0 ) , platform ( ANS , platformid0 ) , title ( ANS , titleid0 )
what jobs are there in locid0 for titleid0 area areaid0 on platformid0 using languageid0 ?	job ( ANS ) , loc ( ANS , locid0 ) , title ( ANS , titleid0 ) , area ( ANS , areaid0 ) , platform ( ANS , platformid0 ) , language ( ANS , languageid0 )
what jobs are there for languageid0 titleid0 that require a degid0 ?	job ( ANS ) , language ( ANS , languageid0 ) , title ( ANS , titleid0 ) , req_deg ( ANS , degid0 )
	
what jobs in companyid0 in locid0 do not need a degree ?	job ( ANS ) , company ( ANS , companyid0 ) , loc ( ANS , locid0 ) , \+ req_deg ( ANS )
what jobs in locid0 need knowledge in platformid0 ?	job ( ANS ) , loc ( ANS , locid0 ) , platform ( ANS , platformid0 )
	
	
	
what jobs in locid0 require the use of languageid0 ?	job ( ANS ) , loc ( ANS , locid0 ) , language ( ANS , languageid0 )
give me jobs that require areaid0 experience but no languageid0 ?	job ( ANS ) , area ( ANS , areaid0 ) , req_exp ( ANS ) , \+ language ( ANS , languageid0 )
what jobs are there in locid0 that requires a degid0 ?	job ( ANS ) , loc ( ANS , locid0 ) , req_deg ( ANS , degid0 )
what jobs are there in locid0 that requires experience with platformid0 ?	job ( ANS ) , loc ( ANS , locid0 ) , req_exp ( ANS ) , platform ( ANS , platformid0 )
show me titleid0 jobs requiring experience with platformid0 ?	title ( ANS , titleid0 ) , job ( ANS ) , req_exp ( ANS ) , platform ( ANS , platformid0 )
	
what jobs in locid0 require year0 years of experience ?	job ( ANS ) , loc ( ANS , locid0 ) , req_exp ( ANS , year0 )
what jobs in locid0 require knowledge of the platform platformid0 ?	job ( ANS ) , loc ( ANS , locid0 ) , platform ( ANS , platformid0 )
show me jobs located in locid0 for languageid0 titleid0s ?	job ( ANS ) , loc ( ANS , locid0 ) , language ( ANS , languageid0 ) , title ( ANS , titleid0 )
show jobs for a languageid0 titleid0 familiar with the platformid0 environment ?	job ( ANS ) , language ( ANS , languageid0 ) , title ( ANS , titleid0 ) , platform ( ANS , platformid0 )
show jobs that do not require a degree for languageid0 titleid0s ?	job ( ANS ) , \+ req_deg ( ANS ) , language ( ANS , languageid0 ) , title ( ANS , titleid0 )
	
	
what locid0 jobs that use languageid0 do not require any experience ?	loc ( ANS , locid0 ) , job ( ANS ) , language ( ANS , languageid0 ) , \+ req_exp ( ANS )
	
what jobs in locid0 require experience with platformid0 ?	job ( ANS ) , loc ( ANS , locid0 ) , req_exp ( ANS ) , platform ( ANS , platformid0 )
are there any titleid0 jobs in locid0 ?	title ( ANS , titleid0 ) , job ( ANS ) , loc ( ANS , locid0 )
	
show me jobs at companyid0 requiring a degid0 degree ?	job ( ANS ) , company ( ANS , companyid0 ) , req_deg ( ANS , degid0 )
what jobs in locid0 are there that requires a degid0 with year0 year of experience ?	job ( ANS ) , loc ( ANS , locid0 ) , req_deg ( ANS , degid0 ) , req_exp ( ANS , year0 )
	
	
	
	
what jobs use languageid0 but do not require a degree ?	job ( ANS ) , language ( ANS , languageid0 ) , \+ req_deg ( ANS )
show me locid0 jobs requiring a degid0 ?	loc ( ANS , locid0 ) , job ( ANS ) , req_deg ( ANS , degid0 )
what areaid0 related jobs require a degid0 but no experience ?	area ( ANS , areaid0 ) , job ( ANS ) , req_deg ( ANS , degid0 ) , \+ req_exp ( ANS )
what companyid0 jobs are there that require a degid0 degree ?	company ( ANS , companyid0 ) , job ( ANS ) , req_deg ( ANS , degid0 )
	
what jobs are there for titleid0s that know languageid0 ?	job ( ANS ) , title ( ANS , titleid0 ) , language ( ANS , languageid0 )
are there any platformid0 jobs open ?	platform ( ANS , platformid0 ) , job ( ANS )
	
what jobs are there in locid0 that require a degid0 degree ?	job ( ANS ) , loc ( ANS , locid0 ) , req_deg ( ANS , degid0 )
what jobs are there in locid0 that require year0 years experience ?	job ( ANS ) , loc ( ANS , locid0 ) , req_exp ( ANS , year0 )
what titleid0 jobs are there that require experience ?	title ( ANS , titleid0 ) , job ( ANS ) , req_exp ( ANS )
	
	
	
	
	
what titleid0 jobs in locid0 require a degid0 and languageid0 ?	title ( ANS , titleid0 ) , job ( ANS ) , loc ( ANS , locid0 ) , req_deg ( ANS , degid0 ) , language ( ANS , languageid0 )
	
what are the jobs for a languageid0 titleid0 in locid0 ?	job ( ANS ) , language ( ANS , languageid0 ) , title ( ANS , titleid0 ) , loc ( ANS , locid0 )
	
what job is there for a degid0 with year0 years of experience ?	job ( ANS ) , req_deg ( ANS , degid0 ) , req_exp ( ANS , year0 )
	
	
	
	
what jobs require a degid0 and no experience ?	job ( ANS ) , req_deg ( ANS , degid0 ) , \+ req_exp ( ANS )
	
	
what jobs require at least year0 year of experience in languageid0 ?	job ( ANS ) , req_exp ( ANS , year0 ) , language ( ANS , languageid0 )
	
	
what areaid0 jobs are available that need platformid0 experience and no degree ?	area ( ANS , areaid0 ) , job ( ANS ) , platform ( ANS , platformid0 ) , req_exp ( ANS ) , \+ req_deg ( ANS )
	
what jobs are there for titleid0s who know languageid0 ?	job ( ANS ) , title ( ANS , titleid0 ) , language ( ANS , languageid0 )
what jobs in locid0 desiring a degid0 are there for a languageid0 titleid0 ?	job ( ANS ) , loc ( ANS , locid0 ) , des_deg ( ANS , degid0 ) , language ( ANS , languageid0 ) , title ( ANS , titleid0 )
are there jobs that do not require a degree in locid0 ?	job ( ANS ) , \+ req_deg ( ANS ) , loc ( ANS , locid0 )
	
	
	
	
	
	
show me locid0 jobs requiring a degid0 ?	loc ( ANS , locid0 ) , job ( ANS ) , req_deg ( ANS , degid0 )
does companyid0 have any positions that dont require experience ?	company ( ANS , companyid0 ) , job ( ANS ) , \+ req_exp ( ANS )
	
does companyid0 have any positions that dont require experience ?	company ( ANS , companyid0 ) , job ( ANS ) , \+ req_exp ( ANS )
show me what needs experience ?	job ( ANS ) , req_exp ( ANS )
is languageid0 required for any jobs ?	job ( ANS ) , language ( ANS , languageid0 )
	
is there anything for an old languageid0 titleid0 on platformid0 ?	job ( ANS ) , language ( ANS , languageid0 ) , title ( ANS , titleid0 ) , platform ( ANS , platformid0 )
	
	
	
	
whats available on platformid0 and near locid0 ?	job ( ANS ) , platform ( ANS , platformid0 ) , loc ( ANS , locid0 )
show me whats out there for languageid0 titleid0s on platformid0 ?	job ( ANS ) , language ( ANS , languageid0 ) , title ( ANS , titleid0 ) , platform ( ANS , platformid0 )
	
whats all there ?	job ( ANS )
all ?	job ( ANS )
	
	
	
moving to locid0 need a job with platformid0 languageid0 and companyid0 ?	job ( ANS ) , loc ( ANS , locid0 ) , platform ( ANS , P ) , language ( ANS , languageid0 ) , platform ( ANS , P )
	
	
	
i hold a degree in degid0 in locid0 are there any jobs for me ?	des_deg ( ANS , degid0 ) , loc ( ANS , locid0 ) , job ( ANS )
i want a job that doesnt use platformid0 ?	job ( ANS ) , \+ platform ( ANS , platformid0 )
i want a job that use languageid0 ?	job ( ANS ) , language ( ANS , languageid0 )
i would like to find a job using languageid0 ?	job ( ANS ) , language ( ANS , languageid0 )
i would like to see all the jobs ?	job ( ANS )
what jobs can i find with companyid0 ?	job ( ANS ) , company ( ANS , companyid0 )
	
	
i wish there were some languageid0 jobs in locid0 ?	job ( ANS ) , language ( ANS , languageid0 ) , loc ( ANS , locid0 )
	
	
do you have any jobs involving languageid0 on platformid0 ?	job ( ANS ) , language ( ANS , languageid0 ) , platform ( ANS , platformid0 )
	
i sure would like a languageid0 job at companyid0 involving areaid0s ?	job ( ANS ) , language ( ANS , languageid0 ) , company ( ANS , companyid0 ) , area ( ANS , areaid0 )
id like to see everything ?	job ( ANS )
	
what work do you have available ?	job ( ANS )
show me what jobs there are ?	job ( ANS )
	
	
are there any jobs for people in locid0 that want to program in languageid0 but do not have a degree ?	job ( ANS ) , loc ( ANS , locid0 ) , language ( ANS , languageid0 ) , \+ req_deg ( ANS )
are there any jobs for people in locid0 that want to program in languageid0 but do not have a degree ?	job ( ANS ) , loc ( ANS , locid0 ) , language ( ANS , languageid0 ) , \+ req_deg ( ANS )
where can i work with a degid0 and no experience ?	loc ( A , ANS ) , req_deg ( A , degid0 ) , \+ req_exp ( A )
list the jobs requiring languageid0 a degid0 year0 years experience ?	job ( ANS ) , language ( ANS , languageid0 ) , req_deg ( ANS , degid0 ) , req_exp ( ANS , year0 )
what jobs are there working for companyid0 programming languageid0 for applicationid0 ?	job ( ANS ) , company ( ANS , companyid0 ) , language ( ANS , languageid0 ) , application ( ANS , applicationid0 )
what jobs are there working for companyid0 programming languageid0 for applicationid0 ?	job ( ANS ) , company ( ANS , companyid0 ) , language ( ANS , languageid0 ) , application ( ANS , applicationid0 )
which jobs in locid0 offer for students fresh out of college in areaid0 ?	job ( ANS ) , loc ( ANS , locid0 ) , \+ req_exp ( ANS ) , area ( ANS , areaid0 )
which jobs in locid0 offer for students fresh out of college in areaid0 ?	job ( ANS ) , loc ( ANS , locid0 ) , \+ req_exp ( ANS ) , area ( ANS , areaid0 )
	
	
	
what titleid0 positions in areaid0 companies in locid0 do not require languageid0 ?	title ( ANS , titleid0 ) , job ( ANS ) , area ( ANS , areaid0 ) , loc ( ANS , locid0 ) , \+ language ( ANS , languageid0 )
	
	
show me titleid0 jobs in locid0 ?	title ( ANS , titleid0 ) , job ( ANS ) , loc ( ANS , locid0 )
show me languageid0 jobs requiring a degid0 in locid0 ?	language ( ANS , languageid0 ) , job ( ANS ) , req_deg ( ANS , degid0 ) , loc ( ANS , locid0 )
give me languageid0 jobs on platformid0 ?	job ( ANS ) , platform ( ANS , platformid0 ) , language ( ANS , languageid0 )
are there any platformid0 jobs ?	job ( ANS ) , platform ( ANS , platformid0 )
are there any titleid0 jobs open ?	job ( ANS ) , title ( ANS , titleid0 )
are there any platformid0 titleid0 jobs open in locid0 ?	platform ( ANS , platformid0 ) , title ( ANS , titleid0 ) , job ( ANS ) , loc ( ANS , locid0 )
what areaid0 jobs are there ?	job ( ANS ) , area ( ANS , areaid0 )
what jobs are there for locid0 platformid0 titleid0 using languageid0 ?	job ( ANS ) , loc ( ANS , locid0 ) , platform ( ANS , platformid0 ) , title ( ANS , titleid0 ) , language ( ANS , languageid0 )
	
all the jobs please ?	job ( ANS )
